# MyDelay library
MyDelay	KEYWORD1
isInterval	KEYWORD2
start	KEYWORD2
stop    KEYWORD2
resume	KEYWORD2
reset	KEYWORD2
setInterval	KEYWORD2

# SerialArduToArdu library
SerialArduToArdu	KEYWORD1
begin	KEYWORD2
sendString	KEYWORD2
sendState	KEYWORD2
sendBool	KEYWORD2
sendInteger	KEYWORD2
sendDecimal	KEYWORD2
readSerial	KEYWORD2
getKey	KEYWORD2
getValueString	KEYWORD2
getValueBool	KEYWORD2
getValueState	KEYWORD2
getValueInteger	KEYWORD2
getValueDouble	KEYWORD2